20  20
6  1  13 1  13 1  13 1  13 1  6  1  0  0  6  1  9  1  10 1  9  1  10 1  9  1  10 1  9  1  10 1  9  1  10 1  9  1  10 1
13 1  0  0  0  0  0  0  0  0  13 1  0  0  13 1  11 1  12 1  11 1  12 1  11 1  12 1  11 1  12 1  11 1  12 1  11 1  12 1
9  1  10 1  0  0  0  0  0  0  0  0  0  0  0  0  0  0  0  0  0  0  0  0  9  1  10 1  0  0  0  0  0  0  0  0  9  1  10 1
11 1  12 1  0  0  0  0  0  0  0  0  1  0  0  0  0  0  0  0  0  0  0  0  11 1  12 1  0  0  0  0  0  0  0  0  11 1  12 1
9  1  10 1  0  0  0  0  0  0  0  0  1  0  1  0  0  0  0  0  0  4  1  4  1  0  9  1  10 1  0  0  0  0  0  0  9  1  10 1
11 1  12 1  0  0  0  0  0  0  0  0  1  0  1  0  0  0  0  0  0  4  1  4  1  0  11 1  12 1  0  0  0  0  0  0  11 1  12 1
9  1  10 1  0  0  0  0  0  0  0  0  0  0  0  0  0  0  0  0  0  4  1  4  1  0  0  0  0  0  0  0  0  0  0  0  9  1  10 1
11 1  12 1  0  0  0  0  0  0  0  0  0  0  0  0  0  0  0  0  0  4  1  4  1  0  0  0  0  0  0  0  0  0  0  0  11 1  12 1
9  1  10 1  2  0  0  0  0  0  0  0  0  0  0  0  0  0  0  0  0  0  0  0  0  0  0  0  0  0  0  0  0  0  0  0  9  1  10 1
11 1  12 1  2  0  0  0  0  0  0  0  0  0  0  0  0  0  0  0  0  0  0  0  0  0  0  0  0  0  0  0  0  0  0  0  11 1  12 1
9  1  10 1  2  0  0  0  0  0  0  0  0  0  0  0  0  0  0  0  0  0  0  0  0  0  0  0  0  0  0  0  0  0  0  0  9  1  10 1
11 1  12 1  0  0  0  0  0  0  0  0  0  0  0  0  0  0  0  0  0  0  0  0  0  0  0  0  0  0  0  0  0  0  0  0  11 1  12 1
9  1  10 1  0  0  0  0  0  0  0  0  0  0  0  0  0  0  0  0  0  0  0  0  0  0  0  0  0  0  0  0  0  0  0  0  9  1  10 1
11 1  12 1  0  0  0  0  0  0  0  0  0  0  0  0  0  0  0  0  0  0  0  0  0  0  0  0  0  0  0  0  0  0  0  0  11 1  12 1
23 1  24 1  0  0  0  0  0  0  0  0  23 1  24 1  0  0  0  0  23 1  24 1  0  0  0  0  0  0  0  0  0  0  0  0  9  1  10 1
25 1  26 1  33 0  33 0  33 0  33 0  25 1  26 1  33 0  33 0  25 1  26 1  33 0  33 0  20 0  0  0  0  0  0  0  11 1  12 1
21 1  22 1  14 0  15 0  14 0  14 0  14 0  14 0  14 0  14 0  14 0  14 0  14 0  17 0  14 0  20 0  0  0  0  0  0  0  0  0
25 1  26 1  14 0  14 0  14 0  16 0  14 0  14 0  15 0  14 0  14 0  14 0  15 0  14 0  14 0  14 0  33 0  33 0  33 0  33 0
30 1  29 1  29 1  29 1  29 1  29 1  29 1  29 1  29 1  29 1  29 1  29 1  29 1  29 1  29 1  31 1  21 1  22 1  21 1  22 1
28 1  28 1  32 1  28 1  28 1  32 1  28 1  32 1  28 1  28 1  28 1  28 1  28 1  28 1  28 1  28 1  25 1  26 1  25 1  26 1